Paladin Took	m	Hobbit		
Tindómiel	f	Man		
Nora Bolger	f	Hobbit		
Bruno Bracegirdle	m	Hobbit		
Adrahil	m	Man		
Fëanor	m	Elf	Curufinwë, Fëanáro	
Orodreth	m	Elf		
Maeglin	m	Elf		
Rowan	f	Hobbit		
Mimosa Bunce	f	Hobbit		
Radagast	m	Maia	Aiwendil	
Dairuin	m	Man		
Bombur	m	Dwarf		
Angelica Baggins	f	Hobbit		
Tuor	m	Man		
Vidugavia	m	Man		
Celepharn	m	Man		
Wulf	m	Man		
Bingo Baggins	m	Hobbit		
Bill Ferny	m	Man		
Polo Baggins	m	Hobbit		
Marmadas Brandybuck	m	Hobbit		
Elemmakil	m	Elf		
Tata	m	Elf		
Ulfang the Black	m	Man		
Galdor the Tall	m	Man		
Nár	m	Dwarf		
Morwen	f	Man		
Thrór	m	Dwarf		
Grimbeorn	m	Man		
Melilot Brandybuck	f	Hobbit		
Baran	m	Man		
Berilac Brandybuck	m	Hobbit		
Saruman	m	Maia	Curumo	
Tar-Minastir	m	Man		
Hirluin	m	Man		
Araphor	m	Man		
Celebrindor	m	Man		
Elros	m	Half-elf	Minyatur	
Dori	m	Dwarf		
Fatty Lumpkin	m	pony		
Glóin	m	Dwarf		
Isengrim Took	m	Hobbit		
Carcharoth	m	werewolf	Anfauglir	
Sackville	f	Hobbit		
Fastolph Bolger	m	Hobbit		
Arvegil	m	Man		
Marmadoc Brandybuck	m	Hobbit		
Hilda Bracegirdle	f	Hobbit		
Valacar	m	Man		
Fladrif	m	Ent		
Hareth	m	Man		
Herefara	m	Man		
Gorbulas Brandybuck	m	Hobbit		
Gamling	m	Man		
Hallatan	m	Man		
Eofor	m	Man		
Ciryon	m	Man		
Adalgar Bolger	m	Hobbit		
Telemnar	m	Man		
Arahad	m	Man		
Doderic Brandybuck	m	Hobbit		
Togo Goodbody	m	Hobbit		
Yávien	f	Man		
Halfred Gamgee	m	Hobbit		
Pallando	m	Maia		
Gerontius Took	m	Hobbit	Old Took	
Hamfast Gamgee	m	Hobbit	Gaffer	
Dírhael	m	Man		
Aragorn Elessar	m	Man	Elessar, Estel, Strider	
Nerdanel	f	Elf		
Eärendil	m	Man		
Nahar	m	horse		
Silmariën	f	Man		
Hanna Goldworthy	f	Hobbit		
Aulë	m	Vala		
Nessanië	f	Man		
Tar-Anárion	m	Man		
Beregar	m	Man		
Milo Burrows	m	Hobbit		
Thorondir	m	Man		
Ilmarë	f	Maia		
Lúthien	f	Elf	Tinúviel	
Erestor	m	Elf		
Sador	m	Man		
Arroch	?	horse		
Déorwine	m	Man		
Nolondil	m	Man		
Orgulas Brandybuck	m	Hobbit		
Olo Proudfoot	m	Hobbit		
Duinhir	m	Man		
Malach	m	Man		
Gwaihir	m	eagle		
Niënor	f	Man		
Ted Sandyman	m	Man		
Jago Boffin	m	Hobbit		
Calimehtar	m	Man		
Hildibrand Took	m	Hobbit		
Hallas	m	Man		
Bregalad	m	Ent	Quickbeam	
Orophin	m	Elf		
Ulwarth	m	Man		
Lothíriel	f	Man		
Galadhon	m	Elf		
Déagol	m	Hobbit	Nahald	
Fíriel Fairbairn	f	Hobbit		
Bór	m	Man		
Finarfin	m	Elf	Arafinwë, Ingalaurë	
Malva Headstrong	f	Hobbit		
Diamond	f	Hobbit		
Poppy Chubb-Baggins	f	Hobbit		
Dáin	m	Dwarf		
Hador Lórindol	m	Man		
Jessamine Boffin	f	Hobbit		
Drogo Baggins	m	Hobbit		
Gildor	m	Man		
Telchar	m	Dwarf		
Targon	m	Man		
Linda Baggins	f	Hobbit		
Voronwë	m	Elf	Aranwion	
Estella Bolger	f	Hobbit		
Arthad	m	Man		
Ulbar	m	Man		
Argonui	m	Man		
Isumbras Took	m	Hobbit		
Elboron	m	Man		
Vardamir	m	Man	Nólimon	
Thingol	m	Elf	Elwë	
Belecthor	m	Man		
Míriel Therindë	f	Elf		
Primula Brandybuck	f	Hobbit		
Aranuir	m	Man		
Castamir the Usurper	m	Man		
Bill	m	Troll	William Huggins	
Barahir	m	Man		
Heribald Bolger	m	Hobbit		
Maedhros	m	Elf		
Lorgan	m	Man		
Théoden	m	Man		
Beldir	m	Man		
Will Whitfoot	m	Hobbit		
Primrose Boffin	f	Hobbit		
Falco Chubb-Baggins	m	Hobbit		
Írildë	f	Man		
Firefoot	m	horse		
Númendil	m	Man		
Beren Erchamion	m	Man	Camlost	
Snaga	m	Orc		
Náli	m	Dwarf		
Argon	m	Elf	Arakáno	
Eradan	m	Man		
Rudigar Bolger	m	Hobbit		
Thráin	m	Dwarf		
Tolman Gardner	m	Hobbit	Tom	
Ivorwen	f	Man		
Mauhúr	m	Orc		
Gríma Wormtongue	m	Man	Wormtongue	
Tar-Amandil	m	Man	Aphanuzir	
Ar-Sakalthôr	m	Man	Falassion	
Tar-Elendil	m	Man	Parmaitë	
Meriadoc Brandybuck	m	Hobbit	Holdwine, Merry	
Hildifons Took	m	Hobbit		
Strider	m	pony		
Beechbone	m	Ent		
Uffo Boffin	m	Hobbit		
Brown	f	Hobbit		
Galadriel	f	Elf	Alatáriel, Artanis, Nerwen	
Gelmir	m	Elf		
Gildis	f	Man		
Arvedui	m	Man		
Lórien	m	Vala	Irmo	
Findegil	m	Man		
Oropher	m	Elf		
Tulkas	m	Vala		
Tar-Telperiën	f	Man		
Elfhild	f	Man		
Hatholdir	m	Man		
Isilmo	m	Man		
Beldis	f	Man		
Dúnhere	m	Man		
Borin	m	Dwarf		
Asfaloth	?	horse		
Mallor	m	Man		
Gwindor	m	Elf		
Hob Gammidge	m	Hobbit		
Ilberic Brandybuck	m	Hobbit		
Seredic Brandybuck	m	Hobbit		
Aratan	m	Man		
Merimac Brandybuck	m	Hobbit		
Zamîn	f	Man		
Fosco Baggins	m	Hobbit		
Hobson Gamgee	m	Hobbit	Roper	
Wilibald Bolger	m	Hobbit		
Roäc	m	raven		
Bain	m	Man		
Hador	m	Man		
Muzgash	m	Orc		
Reginard Took	m	Hobbit		
Eärnil	m	Man		
Gárulf	m	Man		
Ciryandil	m	Man		
Marcho	m	Hobbit		
Arahael	m	Man		
Angrim	m	Man		
Tom Bombadil	m	unknown		
Nob	m	Hobbit		
Tar-Míriel	f	Man	Zimraphel	
Freca	m	Man		
Herugar Bolger	m	Hobbit		
Holman Greenhand	m	Hobbit		
Ivy Goodenough	f	Hobbit		
Fingon	m	Elf	Findekáno	
Shelob	f	spider		
Elrohir	m	Half-elf		
Blanco Bracegirdle	m	Hobbit		
Ailinel	f	Man		
Arador	m	Man		
Soronto	m	Man		
Déor	m	Man		
Éothain	m	Man		
Vëantur	m	Man		
Halmir	m	Man		
Bert	m	Troll		
Herubrand	m	Man		
Tar-Alcarin	m	Man		
Thuringwethil	f	vampire		
Gruffo Boffin	m	Hobbit		
Gildor Inglorion	m	Elf		
Grór	m	Dwarf		
Haldir	m	Man		
Fuinur	m	Man		
Amroth	m	Elf		
Beren	m	Man		
Adelard Took	m	Hobbit		
Minto Burrows	m	Hobbit		
Gorlim	m	Man		
Curufin	m	Elf	Atarinkë, Curufinwë	
Hildigard Took	f	Hobbit		
Morwen Steelsheen	f	Man		
Eldarion	m	Man		
Felaróf	m	horse		
Elladan	m	Half-elf		
Ufthak	m	Orc		
Hamfast Gardner	m	Hobbit		
Haldad	m	Man		
Herion	m	Man		
Carl Cotton	m	Hobbit		
Bungo Baggins	m	Hobbit		
Nina Lightfoot	f	Hobbit		
Tar-Ancalimon	m	Man		
Denethor	m	Man		
Bowman Cotton	m	Hobbit	Nick	
Belladonna Took	f	Hobbit		
Emeldir	f	Man		
Forthwini	m	Man		
Bilbo Baggins	m	Hobbit		
Cirion	m	Man		
Araval	m	Man		
Erling Greenhand	m	Hobbit		
Algund	m	Man		
Tarannon	m	Man	Falastur	
Elfhelm	m	Man		
Almiel	f	Man		
Finduilas	f	Man		
Donnamira Took	f	Hobbit		
Dís	f	Dwarf		
Eärwen	f	Elf		
Egalmoth	m	Elf		
Elmo	m	Elf		
Nessa	f	Vala		
Elendil	m	Man		
Dwalin	m	Dwarf		
Pearl Took	f	Hobbit		
Azog	m	Orc		
Madoc Brandybuck	m	Hobbit		
Annael	m	Elf		
Buffo Boffin	m	Hobbit		
Telumehtar	m	Man	Umbardacil	
Ulmo	m	Vala		
Siriondil	m	Man		
Prisca Baggins	f	Hobbit		
Elendur	m	Man		
Îbal	m	Man		
Ar-Zimrathôn	m	Man	Hostamir	
Aravir	m	Man		
Dírhavel	m	Man		
Turgon	m	Elf		
Galathil	m	Elf		
Círdan	m	Elf		
Gundor	m	Man		
Ar-Adûnakhôr	m	Man	Herunúmen	
Goldberry	f	unknown		
Borthand	m	Man		
Tar-Ardamin	m	Man	Abattârik	
Túrin	m	Man		
Rorimac Brandybuck	m	Hobbit	Rory	
Rollo Boffin	m	Hobbit		
Minastan	m	Man		
Gimilzagar	m	Man		
Proudfoot	m	Hobbit		
Elurín	m	Half-elf		
Aegnor	m	Elf	Aikanáro, Ambaráto	
Salmar	m	Maia		
Ungoliant	m	spider		
Treebeard	m	Ent	Fangorn	
Boromir	m	Man		
Pengolodh	m	Elf		
Gilmith	f	Half-elf		
Gethron	m	Man		
Gundahar Bolger	m	Hobbit		
Glirhuin	m	Man		
Orodreth	m	Man		
Imin	m	Elf		
Mirabella Took	f	Hobbit		
Belba Baggins	f	Hobbit		
Finwë	m	Elf	Ñoldóran	
Ar-Pharazôn	m	Man	Calion	
Enel	m	Elf		
Tobold Hornblower	m	Hobbit		
Saradas Brandybuck	m	Hobbit		
Melkor	m	Vala	Morgoth	
Bell Goodchild	f	Hobbit		
Rosie Cotton	f	Hobbit		
Tarondor	m	Man		
Atanalcar	m	Man		
Bill	m	pony		
Hasufel	m	horse		
Filibert Bolger	m	Hobbit		
Borlad	m	Man		
Rowlie Appledore	m	Man		
Lenwë	m	Elf		
Vorondil the Hunter	m	Man		
Dina Diggle	f	Hobbit		
Marhwini	m	Man		
Beril	f	Man		
Oromendil	m	Man		
Kíli	m	Dwarf		
Hugo Boffin	m	Hobbit		
Tolman Cotton	m	Hobbit		
Ulrad	m	Man		
Anardil	m	Man		
Ruby Bolger	f	Hobbit		
Belen	m	Man		
Barliman Butterbur	m	Man		
Haldan	m	Man		
Calmacil	m	Man		
Imrahil	m	Man		
Tarcil	m	Man		
Bard the Bowman	m	Man		
Tar-Vanimeldë	f	Man		
Hamfast of Gamwich	m	Hobbit		
Glorfindel	m	Elf		
Thorondor	m	eagle		
Farmer Maggot	m	Hobbit		
Gilly Brownlock	f	Hobbit		
Angbor	m	Man		
Idril	f	Elf	Celebrindal	
Largo Baggins	m	Hobbit		
Mentha Brandybuck	f	Hobbit		
Aredhel	f	Elf	Ar-Feiniel, Írissë	
Dora Baggins	f	Hobbit		
Borlach	m	Man		
Vigo Boffin	m	Hobbit		
Aldor	m	Man		
Stybba	m	pony		
Rudolph Bolger	m	Hobbit		
Gálmód	m	Man		
Ceorl	m	Man		
Bëor	m	Man	Balan	
Isembard Took	m	Hobbit		
Mablung	m	Man		
Cotman	m	Hobbit		
Borondir	m	Man		
Bucca	m	Hobbit		
Fréawine	m	Man		
Gimilkhâd	m	Man		
Gormadoc Brandybuck	m	Hobbit		
Malantur	m	Man		
Brodda	m	Man		
Gundahad Bolger	m	Hobbit		
Ciryatur	m	Man		
Fastred	m	Man		
Dorlas	m	Man		
Eilinel	f	Man		
Guthláf	m	Man		
Eöl	m	Elf		
Berylla Boffin	f	Hobbit		
Indis	f	Elf		
Vidumavi	f	Man		
Hyarmendacil	m	Man		
Marroc Brandybuck	m	Hobbit		
Peregrin Took	m	Hobbit	Pippin	
Aravorn	m	Man		
Dior	m	Man		
Pansy Baggins	f	Hobbit		
Mat Heathertoes	m	Man		
Myrtle Burrows	f	Hobbit		
Khamûl	m	Man		
Ingwion	m	Elf		
Grithnir	m	Man		
Angrod	m	Elf	Angaráto	
Tar-Calmacil	m	Man	Belzagar	
Frumgar	m	Man		
Frár	m	Dwarf		
Harding	m	Man		
Alfrida	f	Hobbit		
Artamir	m	Man		
Carc	m	raven		
Belemir	m	Man		
Narmacil	m	Man		
Balin	m	Dwarf		
Arassuil	m	Man		
Theobald Bolger	m	Hobbit		
Arminas	m	Elf		
Ponto Baggins	m	Hobbit		
Esmeralda Brandybuck	f	Hobbit		
Rían	f	Man		
Lóni	m	Dwarf		
Vairë	f	Vala		
Mandos	m	Vala	Námo	
Éomer	m	Man		
Aranwë	m	Elf		
Belegund	m	Man		
Khîm	m	Dwarf		
Thranduil	m	Elf		
Eldacar	m	Man	Vinitharya	
Nimloth	f	Elf		
Flambard Took	m	Hobbit		
Ostoher	m	Man		
Walda	m	Man		
Odovacar Bolger	m	Hobbit		
Salvia Brandybuck	f	Hobbit		
Hundar	f	Man		
Aghan	m	Man		
Finduilas	f	Elf	Faelivrin	
Sackville-Baggins	m	Hobbit		
Bolg	m	Orc		
Tar-Aldarion	m	Man	Anardil
Duilin	m	Man		
Fastred	m	Hobbit		
Ferumbras Took	m	Hobbit		
Aranarth	m	Man		
Blanco	m	Hobbit		
Erkenbrand	m	Man		
Sadoc Brandybuck	m	Hobbit		
Tosto Boffin	m	Hobbit		
Fingolfin	m	Elf	Aracáno, Ñolofinwë	
Ossë	m	Maia		
Folca	m	Man		
Balbo Baggins	m	Hobbit		
Amlaith	m	Man		
Celebrimbor	m	Elf		
Hayward	m	Hobbit		
Dagnir	m	Man		
Elrond	m	Half-elf		
Laura Grubb	f	Hobbit		
Ondoher	m	Man		
Gróin	m	Dwarf		
Gundolpho Bolger	m	Hobbit		
Horn	m	Man		
Irimë	f	Elf		
Bergil	m	Man		
Ghân-buri-Ghân	m	Man		
Tar-Meneldur	m	Man	Írimon	
Éomund	m	Man		
Porto Baggins	m	Hobbit		
Marigold Gamgee	f	Hobbit		
Holfast Gardner	m	Hobbit		
Uldor	m	Man		
Bandobras Took	m	Hobbit		
Merimas Brandybuck	m	Hobbit		
Brandir	m	Man		
Lily Baggins	f	Hobbit		
Gandalf	m	Maia	Mithrandir, Olórin	
Adamanta Chubb	f	Hobbit		
Gothmog	m	Maia		
Náin	m	Dwarf		
Gorbadoc Brandybuck	m	Hobbit		
Denethor	m	Elf		
Hiril	f	Man		
Amlach	m	Man		
Amandil	m	Man		
Tar-Ciryatan	m	Man	Balkumagân	
Eorl the Young	m	Man		
Folcred	m	Man		
Flói	m	Dwarf		
Draugluin	m	werewolf		
Rose	f	Hobbit		
Pervinca Took	f	Hobbit		
Vardilmë	f	Man		
Finglas	m	Ent		
Damrod	m	Man		
Fimbrethil	f	Ent	Wandlimb	
Arien	f	Maia		
Óin	m	Dwarf		
Eldalótë	f	Elf		
Beleg Cúthalion	m	Elf		
Sigismond Took	m	Hobbit		
Anborn	m	Man		
Hamson Gamgee	m	Hobbit		
Mahtan	m	Elf		
Amdír	m	Elf		
Elfwine	m	Man		
Thorin Stonehelm	m	Dwarf		
Gorbag	m	Orc		
Alatar	m	Maia		
Gléowine	m	Man		
Aulendil	m	Man		
Elemmírë	?	Elf		
Aragost	m	Man		
Maglor	m	Elf		
Malvegil	m	Man		
Bob	m	Hobbit		
Eärendur	m	Man		
Ori	m	Dwarf		
Marach	m	Man		
Rudibert Bolger	m	Hobbit		
Arathorn	m	Man		
Ingwë	m	Elf		
Basso Boffin	m	Hobbit		
Fredegar Bolger	m	Hobbit	Fatty	
Manwë	m	Vala		
Eärnur	m	Man		
Olwë	m	Elf		
Elenwë	f	Elf		
Smaug	m	dragon		
Fíli	m	Dwarf		
Durin V	m	Dwarf		
Narvi	m	Dwarf		
Mablung	m	Elf		
Brand	m	Man		
Galion	m	Elf		
Shagrat	m	Orc		
Belegorn	m	Man		
Andreth	f	Man	Saelind	
Celandine Brandybuck	f	Hobbit		
Pelendur	m	Man		
Arveleg	m	Man		
Angelimir	m	Man		
Herucalmo	m	Man	Anducal	
Lugdush	m	Orc		
Eluréd	m	Half-elf		
Banks	f	Hobbit		
Hugo Bracegirdle	m	Hobbit		
Robin Smallburrow	m	Hobbit		
Daisy Baggins	f	Hobbit		
Léod	m	Man		
Isembold Took	m	Hobbit		
Farin	m	Dwarf		
Gamil Zirak	m	Dwarf		
Vána	f	Vala		
Ancalagon	m	dragon		
Mungo Baggins	m	Hobbit		
Anairë	f	Elf		
Aerandir	m	unknown		
Tar-Palantir	m	Man	Inziladûn	
Gollum	m	Hobbit	Sméagol, Trahald	
Thengel	m	Man		
Wilcome Cotton	m	Hobbit	Jolly	
Finrod	m	Elf	Findaráto, Ingoldo, Nóm	
Ulfast	m	Man		
Manwendil	m	Man		
Mosco Burrows	m	Hobbit		
Isilmë	f	Man		
Erendis	f	Man	Elestirnë	
Gardner	m	Hobbit		
Derufin	m	Man		
Marhari	m	Man		
Hending	m	Hobbit		
Amaranth Brandybuck	f	Hobbit		
Egalmoth	m	Man		
Posco Baggins	m	Hobbit		
Findis	f	Elf		
Banks	m	Hobbit		
Durin	m	Dwarf		
Harry Goatleaf	m	Man		
Chica Chubb	f	Hobbit		
Rómendacil	m	Man	Tarostar	
Eönwë	m	Maia		
Tar-Ancalimë	f	Man	Emerwen Aranel	
Aerin	f	Man		
Tanta Hornblower	f	Hobbit		
Gimli	m	Dwarf		
Dudo Baggins	m	Hobbit		
Otto Boffin	m	Hobbit		
Halbarad	m	Man		
Asgon	m	Man		
Nellas	f	Elf		
Faramir Took	m	Hobbit		
Brego	m	Man		
Húrin	m	Man		
Cora Goodbody	f	Hobbit		
Huor	m	Man		
Celeborn	m	Elf	Teleporno	
Andwise Roper	m	Hobbit	Andy	
Wilimar Bolger	m	Hobbit		
Dinodas Brandybuck	m	Hobbit		
Berúthiel	f	Man		
Frodo Baggins	m	Hobbit		
Aragorn	m	Man		
Druda Burrows	f	Hobbit		
Wiseman Gamwich	m	Hobbit		
Fram	m	Man		
Atanatar	m	Man		
Baranor	m	Man		
Celegorm	m	Elf	Turcafinwë, Tyelkormo	
Gundabald Bolger	m	Hobbit		
Háma	m	Man		
Eldacar	m	Man		
Halfast Gamgee	m	Hobbit	Hal	
Elfstan Fairbairn	m	Hobbit		
Bard	m	Man		
Fundin	m	Dwarf		
Celebrían	f	Elf		
Éowyn	f	Man		
Forlong	m	Man		
Fengel	m	Man		
Hallacar	m	Man	Mámandil	
Ecthelion of the Fountain	m	Elf		
Rosa Baggins	f	Hobbit		
Minardil	m	Man		
Frór	m	Dwarf		
Araphant	m	Man		
Cemendur	m	Man		
Daeron	m	Elf		
Nori	m	Dwarf		
Sapphira Brockhouse	f	Hobbit		
Everard Took	m	Hobbit		
Hildigrim Took	m	Hobbit		
Ioreth	f	Man		
Glaurung	m	dragon		
Caliondo	m	Man		
Edrahil	m	Elf		
Orchaldor	m	Man		
Meneldor	m	eagle		
Arciryas	m	Man		
Samwise Gamgee	m	Hobbit	Sam	
Golfimbul	m	Orc		
Dior	m	Half-elf	Aranel, Eluchíl	
Folcwine	m	Man		
Isildur	m	Man		
Helm Hammerhand	m	Man		
Arod	m	horse		
Griffo Boffin	m	Hobbit		
Zimrahin	f	Man	Meldis	
Iorlas	m	Man		
Haldir	m	Elf		
Holman Cotton	m	Hobbit	Long Hom	
Saradoc Brandybuck	m	Hobbit		
Grishnákh	m	Orc		
Turgon	m	Man		
Tom	m	Troll		
Eärendil	m	Half-elf	Ardamírë, Azrubêl	
Brytta	m	Man	Léofa	
Amrod	m	Elf	Ambarussa, Pityafinwë	
Enerdhil	m	Elf		
Dervorin	m	Man		
Inzilbêth	f	Man		
Axantur	m	Man		
Briffo Boffin	m	Hobbit		
Menegilda Goold	f	Hobbit		
Elwing	f	Half-elf		
Rúmil	m	Elf		
Ibûn	m	Dwarf		
Haldar	m	Man		
Lindissë	f	Man		
Andróg	m	Man		
Legolas	m	Elf		
Rómendacil	m	Man	Minalcar	
Azaghâl	m	Dwarf		
Asphodel Brandybuck	f	Hobbit		
Valandil	m	Man		
Adanel	f	Man		
Lotho Sackville-Baggins	m	Hobbit		
Cottar	m	Hobbit		
Gardner	f	Hobbit		
Caranthir	m	Elf	Carnistir, Morifinwë	
Amethyst Hornblower	f	Hobbit		
Thorin	m	Dwarf		
Angelimar	m	Man		
Halfred Greenhand	m	Hobbit		
May Gamgee	f	Hobbit		
Amarië	f	Elf		
Peony Baggins	f	Hobbit		
Shadowfax	m	horse		
Bifur	m	Dwarf		
Lobelia Sackville-Baggins	f	Hobbit		
Estë	f	Vala		
Tar-Atanamir	m	Man		
Faramir	m	Man		
Adalbert Bolger	m	Hobbit		
Fréa	m	Man		
Galdor	m	Elf		
Moro Burrows	m	Hobbit		
Gil-galad	m	Elf	Artanáro, Ereinion, Rodnor	
Gerda Boffin	f	Hobbit		
Tar-Súrion	m	Man		
Thorin Oakenshield	m	Dwarf		
Haleth	f	Man		
Forweg	m	Man		
Erchirion	m	Man		
Bodo Proudfoot	m	Hobbit		
Ardamir	m	Man		
Meneldil	m	Man		
Landroval	m	eagle		
Pimpernel Took	f	Hobbit		
Bosco Boffin	m	Hobbit		
Saeros	m	Man		
Sauron	m	Maia	Annatar	
Fortinbras Took	m	Hobbit		
Boron	m	Man		
Gilraen	f	Man		
Gram	m	Man		
Anárion	m	Man		
Frerin	m	Dwarf		
Bereth	f	Man		
Mairen	f	Man		
Hunthor	m	Man		
Tar-Telemmaitë	m	Man		
Anson Roper	m	Hobbit		
Varda	f	Vala	Elbereth	
Yavanna	f	Vala		
Dáin	m	Dwarf	Ironfoot	
Galador	m	Half-elf		
Dodinas Brandybuck	m	Hobbit		
Adalgrim Took	m	Hobbit		
Baldor	m	Man		
Lalia Clayhanger	f	Hobbit		
Túrin Turambar	m	Man	Adanedhel, Agarwaen, Gorthol, Mormegil, Neithan, Thurin	
Argeleb	m	Man		
Lavender Grubb	f	Hobbit		
Estelmo	m	Man		
Herumor	m	Man		
Longo Baggins	m	Hobbit		
Hirgon	m	Man		
Amras	m	Elf	Telufinwë, Umbarto	
Nienna	f	Vala		
Théodred	m	Man		
Barach	m	Man		
Bereg	m	Man		
Radbug	m	Orc		
Mîm	m	Dwarf		
Rufus Burrows	m	Hobbit		
Girion	m	Man		
Lagduf	m	Orc		
Grimbold	m	Man		
Bofur	m	Dwarf		
Arwen	f	Half-elf	Undómiel	
Núneth	f	Man		
Lindórië	f	Man		
Gothmog	m	unknown		
Rosamunda Took	f	Hobbit		
Beregond	m	Man		
Folco Boffin	m	Hobbit		
Goldwine	m	Man		
Golasgil	m	Man		
Elatan	m	Man		
Araglas	m	Man		
Mithrellas	f	Elf		
Uinen	f	Maia		
Beorn	m	Man		
Adaldrida Bolger	f	Hobbit		
Gorhendad Brandybuck	m	Hobbit		
Tilion	m	Maia		
Uglúk	m	Orc		
Ferdinand Took	m	Hobbit		
Erellont	m	unknown		
Ar-Gimilzôr	m	Man	Telemnar	
Huan	m	wolf		
Mardil Voronwë	m	Man		
Glóredhel	f	Man		
Isengar Took	m	Hobbit		
Ecthelion	m	Man		
Baragund	m	Man		
Beleg	m	Man		
Almarian	f	Man		
Guilin	m	Elf		
Goldilocks Gardner	f	Hobbit		
Melian	f	Maia		
Harding of the Hill	m	Hobbit		
Bregolas	m	Man		
Oromë	m	Vala		
Fréaláf Hildeson	m	Man		
